W 1 ______N__N_N_N__N_______
R -2 _TT_ttt___ttt_TT___TTT__
R 5 ______LLLLLLL_____LLLL__
R -4 TT__tt__TT___TT___tt__TT
R 3 LL____LL_____LL___LL____
R -5 tttt_____TTTT______tttt_
N 0 ________________________
S -3 C__C__C____C__C____C__C_
S 2 _______CCCCC___CCCCC____
S -6 _CC_______CC_________CC_
S 8 C__C____________C_C__C_C
S 3 ____CC____CC____CC______
N 0 ________________________
